1 1 1 1 1 1 1 1 1 1 1 1 1 1 1 1 1 1 1 1 1 1 1 1 1 1 1 1 1 1 1 1 1 1 1 1 1 1
1 12 11 0 0 0 0 0 0 0 0 0 0 0 0 0 0 0 0 0 11 11 0 11 11 11 0 11 11 11 11 0 11 0 11 11 0 1
1 13 17 0 0 0 0 0 0 0 0 0 0 0 0 0 0 0 0 0 0 0 0 11 11 0 11 11 0 11 0 11 11 11 0 0 0 1
1 13 19 20 20 22 0 0 0 0 0 11 0 0 0 0 0 0 0 0 0 0 11 0 11 11 11 11 11 0 0 0 0 0 0 0 0 1
1 13 13 13 13 17 0 0 0 0 0 0 0 0 0 0 0 11 0 0 0 0 11 11 11 11 0 0 0 0 0 0 0 11 0 0 0 1
1 15 15 16 13 17 11 11 11 11 0 0 0 0 0 0 0 0 0 0 0 0 0 0 0 11 0 11 0 0 0 11 0 0 0 0 0 1
1 11 0 18 13 19 20 20 20 20 3 4 4 4 5 0 0 0 0 0 0 0 0 0 0 0 0 0 11 0 0 0 0 0 0 0 0 1
1 0 0 18 13 13 13 13 13 13 6 2 2 2 7 0 0 0 0 0 11 0 0 0 0 0 0 0 0 0 0 0 0 0 0 0 0 1
1 0 0 18 13 13 13 13 13 13 6 2 2 2 7 0 0 0 0 0 0 0 0 0 0 0 0 0 0 0 0 0 11 0 0 0 0 1
1 0 0 23 15 15 15 15 15 15 8 9 9 9 10 0 0 0 0 0 0 0 0 0 0 0 0 0 0 0 0 0 0 0 0 0 0 1
1 0 0 0 0 11 11 11 11 11 0 0 0 0 0 0 0 0 0 0 0 0 11 0 0 0 0 0 0 0 0 0 0 0 0 0 0 1
1 0 0 0 0 0 0 0 0 0 0 0 0 0 0 0 0 11 0 0 0 0 0 0 0 0 0 0 0 11 0 0 0 0 0 0 0 1
1 0 0 0 0 0 0 0 0 0 0 0 0 0 0 0 0 0 0 0 11 0 0 0 0 0 0 0 0 0 0 0 0 0 0 0 0 1
1 0 0 11 0 0 0 0 0 0 11 0 0 0 0 0 0 0 0 0 0 0 0 0 0 0 0 0 0 0 0 0 11 0 0 0 0 1
1 11 11 11 0 0 0 0 0 0 0 0 0 0 11 0 0 0 0 0 0 11 0 0 0 0 0 0 0 0 0 0 0 0 0 0 0 1
1 0 0 0 0 0 0 0 0 0 0 0 0 0 0 0 0 0 0 0 0 0 0 0 0 0 0 0 0 0 0 0 0 0 0 0 0 1
1 1 1 1 1 1 1 1 1 1 1 1 1 1 1 1 1 1 1 1 1 1 1 1 1 1 1 1 1 1 1 1 1 1 1 1 1 1